一彈指	yi dan zhi
丈夫有淚不輕彈	zhang fu you lei bu qing tan
中子彈	zhong zi dan
中彈	zhong dan
亂彈	luan dan
以珠彈雀	yi zhu dan que
信號彈	xin hao dan
偷彈珠淚	tou dan zhu lei
催淚彈	cui lei dan
光纖飛彈	guang xian fei dan
光陰彈指	guang yin tan zhi
動彈	dong tan
動彈不得	dong dan bu de
包彈	bao dan
北極星飛彈	bei ji xing fei dan
原子彈	yuan zi dan
反彈	fan tan
反彈琵琶	fan dan pi pa
反飛彈	fan fei dan
古調獨彈	gu tiao du dan
吹彈	chui tán
品竹彈絲	pin zhu tan si
塑膠炸彈	su jiao zha dan
子彈	zi dan
宓子賤彈鳴琴	fu zi jian dan ming qin
定時炸彈	ding shi zha dan
宣傳彈	xuan chuan dan
實彈射擊	shi dan she ji
實心彈	shi xin dan
對牛彈琴	dui niu tan qin
導向飛彈	dao xiang fei dan
導彈	dao dan
巡弋飛彈	xun yi fei dan
巡航導彈	xun hang dao dan
彈丸	dan wan
彈丸之地	dan wan zhi di
彈冠	tan guan
彈冠振衣	tan guan zhen yi
彈冠相慶	tan guan xiang qing
彈冠結綬	tan guan jie shou
彈出	tan chu
彈出一個	dan chu yi ge
彈出來	dan chu lai
彈出窗口	dan chu chuang kou
彈剝	tan bo
彈力	dan li
彈劾	tan he
彈劾權	tan he quan
彈劾無私	dan he wu si
彈包	dan bao
彈唱	tan chang
彈坑	dan keng
彈塗魚	dan tu yu
彈壓	dan ya
彈奏	dan zou
彈子房	dan zi fang
彈子檯	tan zi tai
彈射	dan she
彈布爾	dan bu er
彈弄	dan nong
彈弓	tan gong
彈性	dan xing
彈性上班	dan xing shang ban
彈性勢能	tan xing shi neng
彈性工時	tan xing gong shi
彈性放假	tan xing fang jia
彈性模數	dan xing mu shu
彈性疲乏	tan xing pi fa
彈性纖維	tan xing xian wei
彈性製造系統	dan xing zhi zao xi tong
彈性限度	dan xing xian du
彈指	tan zhi
彈指之間	dan zhi zhi jian
彈指神功	tan zhi shen gong
彈掙	dan zheng
彈斤估兩	dan jin gu liang
彈棋	tan qí
彈殼	tan ke
彈治	dan zhi
彈治	tan zhi
彈無虛發	dan wu xu fa
彈片	dan pian
彈珠	dan zhu
彈珠檯	dan zhu tai
彈琴	dan qin
彈琵琶	tan pi pa
彈痕分析	dan hen fen xi
彈盡援絕	dan jin yuan jue
彈着點	tan zhuo dian
彈空說嘴	dan kong shuo zui
彈章	tan zhang
彈簧	dan huang
彈簧刀	tan huang dao
彈簧牀	dan huang chuang
彈簧秤	dan huang cheng
彈簧鋼	dan huang gang
彈簧門	dan huang men
彈絲品竹	tan si pin zhu
彈腿	dan tui
彈藥	dan yao
彈觔估兩	dan jin gu liang
彈詞	dan ci
彈跳	dan tiao
彈道	dan dao
彈道導彈	dan dao dao dan
彈道飛彈	dan dao fei dan
彈針	dan zhen
彈鋏	tan jia
彈鋏無魚	tan jia wu yu
彈鋼琴	dan gang qin
彈雨	tan yu
彈頭	dan tou
彈駁	dan bo
彈黃調	tán huang diao
愛國者飛彈	ai guo zhe fei dan
所得彈性	suo de dan xing
手榴彈	shou liu dan
打彈	da dan
打彈子	da dan zi
打彈珠	da dan zhu
投彈	tou dan
抨彈	peng tan
挖地彈	wa di dan
揚州彈詞	yang zhou tan ci
搊彈詞	chou dan ci
擲彈筒	zhi dan tong
斑鳩跌彈	ban jiu die tan
新沐者必彈冠	xin mu zhe bi tan guan
明珠彈雀	ming zhu dan qiao
星點彈塗	xing dian tan tu
曳光彈	ye guang dan
核彈	hu dan
核彈頭	he dan tou
械彈	xie dan
榴彈	liu dan
榴彈炮	liu dan pao
榴霰彈	liu xian dan
槍彈	qiang dan
槍林彈雨	qiang lin dan yu
氣爆彈	qi bo dan
氫彈	qing dan
沒包彈	mei bao dan
沒彈剝	mei dan bo
油氣彈	you qi dan
洲際飛彈	zhou ji fei dan
流彈	liu tan
深水炸彈	shen shui zha dan
潛水炸彈	qian shui zha dan
濯纓彈冠	zhuo ying tan guan
火箭彈	huo jian dan
炮彈	pao dan
炸彈	zha dan
煙幕彈	yan mu dan
照明彈	zhao ming dan
燒夷彈	shao yi dan
王貢彈冠	wang gong tan guan
珠淚偷彈	zhu lei tou tan
班鳩跌彈	ban jiu die dan
瓦斯彈	wa si tan
男兒有淚不輕彈	nan er you lei bu qing tan
硝煙彈雨	xiao yan dan yu
空包彈	kong bao dan
穿甲彈	chuan jia dan
糖衣炮彈	tang yi pao dan
糾彈	jiu tan
紙彈	zhi dan
紙彈	zhi tan
義勇兵飛彈	yi yong bing fei dan
老調重彈	lao diao chong tan
聯彈	lian dan
肉彈	rou dan
舊調重彈	jiu tiáo chong dàn
色彈	se dan
色彈	shai dan
荷槍實彈	he qiang shi dan
葡萄炸彈	pu tao zha dan
蘇州彈詞	su zhou tan ci
蘇州評彈	su zhou ping tan
蠟彈	la dan
褒彈	bao tan
見彈求鴞	jiàn dan qiu xiao
見彈而求鴞炙	jian dan er qiu xiao zhi
評彈	ping tan
貢禹彈冠	gong yu tan guan
跌了彈的斑鳩	die le dan de ban jiu
跳彈	tiao tan
達姆達姆彈	da mu da mu tan
郵寄炸彈	you ji zha dan
鈽彈	bu dan
銀彈	yin dan
鎗彈	qiang dan
鎗榴彈	qiang liu dan
間繞式彈簧	jian rao shi dan huang
防彈衣	fang dan yi
防空飛彈	fang kong fei dan
隨珠彈雀	sui zhu dan que
震撼彈	zhen han dan
霰彈	xian dan
響尾蛇飛彈	xiang wei she fei dan
飛彈	fei dan
飛彈快艇	fei dan kuai ting
飛毛腿飛彈	fei mao tui fei dan
飛魚飛彈	fei yu fei dan
飲彈	yin dan
馮諼彈鋏	feng xuan dan jia
高爆彈	gao bao dan
高空彈跳	gao kong dan tiao
鳴彈	ming tan
鷹式飛彈	ying shi fei dan
黃連樹下彈琴	huang lian shu xia tan qin
