一乾二淨	yi qian er jing
不乾不淨	fou gan fou cheng
不乾性油	fou qian xing you
不乾淨	bu qian jing
乳臭未乾	ru xiu wei qian
乾乾	gan qian
乾乾	qian qian
乾乾淨淨	qian qian jing jing
乾井	qian jing
乾元	qian yuan
乾兒子	gan er zi
乾冰	qian bing
乾冷	qian leng
乾刻版	qian ke ban
乾剝剝	qian bo bo
乾吊着下巴	qian diao zhao xia ba
乾和	gan he
乾和	gan huo
乾咳	qian ke
乾咽	qian yan
乾哭	qian ku
乾啼濕哭	qian ti shi ku
乾喬	gan qiao
乾嘔	qian ou
乾噦	qian hui
乾嚎	gan hao
乾嚥唾	gan yan tuo
乾回付	qian hui fu
乾圓潔淨	qian yuan jie jing
乾圖	qian tu
乾坤	qian kun
乾坤一擲	qian kun yi zhi
乾坤再造	qian kun zai zao
乾塢	qian wu
乾女兒	qian nv er
乾奴才	gan nu cai
乾妹妹	qian mei mei
乾娘	qian niang
乾媽	qian ma
乾季	qian ji
乾宅	qian zhai
乾屎橛	qian shi jue
乾巴	qian ba
乾巴巴	qian ba ba
乾巴疵咧	gan ba ci lie
乾巴疵咧	gan ba zhai lie
乾巴疵咧	qian ba ci lie
乾巴疵咧	qian ba zhai lie
乾急	qian ji
乾打雷	qian da lei
乾折	qian zhe
乾撂臺	gan liao tai
乾撇下	qian pie xia
乾擦	qian ca
乾支剌	qian zhi la
乾支支	gan qi zhi
乾敲梆子不賣油	qian qiao bang zi bu mai you
乾料	qian liao
乾斷	qian duan
乾旦	qian dan
乾旱	qian han
乾暖	qian nuan
乾曜	gan yao
乾村沙	qian cun sha
乾杯	gan bei
乾果	gan guo
乾果	qian guo
乾枯	qian ku
乾柴	qian chai
乾柴烈火	qian chai lie huo
乾梅	qian mei
乾死	gan si
乾死	qian si
乾沒	gan mei
乾洗	qian xi
乾涸	qian he
乾淨	qian jing
乾淨俐落	qian jing li luo
乾淨爽利	qian jing shuang li
乾清宮	qian qing gong
乾渴	qian ke
乾溼	qian shi
乾澀	qian se
乾熬	qian ao
乾熱	qian re
乾燥	qian zao
乾燥劑	qian zao ji
乾燥器	qian zao qi
乾燥機	qian zao ji
乾燥氣候	qian zao qi hou
乾燥箱	qian zao xiang
乾燥花	qian zao hua
乾爹	qian die
乾爽	qian shuang
乾片	qian pian
乾生受	qian sheng shou
乾生子	gan sheng zi
乾生子	qian sheng zi
乾產	gan chan
乾疥	qian jie
乾瘦	qian shou
乾癟	qian bie
乾眼症	qian yan zheng
乾着	qian zhuo
乾着急	gan zhao ji
乾瞪眼	qian deng yan
乾禮	gan li
乾稿	qian gao
乾笑	qian xiao
乾等	qian deng
乾篾片	qian mie pian
乾粉	qian fen
乾糧	qian liang
乾紅	gan hong
乾結	qian jie
乾絲	qian si
乾綱	gan gang
乾罷	qian bai
乾耗	qian mao
乾股	qian gu
乾肥	qian fei
乾脆	qian cui
乾脆爽快	qian cui shuang kuai
乾花	qian hua
乾芻	gan chu
乾苔	qian tai
乾茨臘	gan ci la
乾茨臘	qian ci la
乾茶錢	gan cha qian
乾草	qian cao
乾菜	gan cai
乾落	gan luo
乾落	qian luo
乾落得	qian luo de
乾薑	qian jiang
乾薪	qian xin
乾虔	gan qian
乾號	qian hao
乾衣機	qian yi ji
乾裂	qian lie
乾親	qian qin
乾親家	qian qin jie
乾象	gan xiang
乾象	qian xiang
乾貨	qian huo
乾貨船	qian huo chuan
乾造	qian zao
乾逼	qian bi
乾道	gan dao
乾道	qian dao
乾酪	qian luo
乾量	qian liang
乾阿嬭	gan e nai
乾陵	qian ling
乾隆	qian long
乾電池	qian dian chi
乾霍亂	gan he luan
乾顙	qian sang
乾颱	qian tai
乾飯	qian fan
乾館	gan guan
乾館	qian guan
乾餱	qian hou
乾餱以愆	qian hou yi qian
乾餾	gan liu
乾魚與貓作枕頭	gan yu yu mao zuo zhen tou
乾麪	qian mian
偎乾就濕	wei qian jiu shi
全彩乾式印表機	quan cai gan shi yin biao ji
口乾舌燥	kou qian she sao
口燥脣乾	kou zao chun gan
口血未乾	kou xie wei qian
唾面自乾	tuo mian zi gan
喫乾醋	chi qian cu
喫幾碗乾飯	chi ji wan gan fan
壺裏乾坤	hu li gan kun
壺裏乾坤	hu li qian kun
外強中乾	wai qiang zhong gan
大目乾連冥間救母變文	da mu gan lian ming jian jiu mu bian wen
天乾物燥	tian qian wu zao
夾心餅乾	jia xin bing gan
弄乾坤	long qian kun
打乾噦	da qian hui
打淨撈乾	da jing lao qian
扭轉乾坤	niu zhuan qian kun
抔土未乾	pou tu wei qian
揩乾	kai qian
搭乾鋪	ta qian pu
擰乾	ning gan
旋乾轉坤	xuan qian zhuan kun
旋轉乾坤	xuan zhuan gan kun
晒乾	shai gan
晾乾	liang qian
朝乾夕惕	zhao qian xi ti
果乾	luo qian
枯乾	ku qian
桑乾河	sang qian he
桑乾盆地	sang qian pen di
沒乾沒淨	mei qian mei jing
沒乾淨	mei gan jing
河涸海乾	he he hai qian
河落海乾	he luo hai gan
洋乾漆	yang qian qi
浪蕩乾坤	lang dang gan kun
海乾河盡	hai qian he jin
涸乾	he qian
淚乾腸斷	lei qian chang duan
濕肉伴乾柴	shi rou pan qian chai
烈火乾柴	lie huo qian chai
烘乾	hong gan
烘乾機	hong gan ji
焙乾	bei qian
煨乾就濕	wei qian jiu shi
煨乾避濕	yu qian bi shi
甕盡杯乾	weng jin bei qian
瘦小枯乾	shou xiao ku gan
白乾	bai qian
眼球乾燥症	yan qiu qian zao zheng
筍乾	sun qian
糕乾	gao qian
老乾	lao qian
肉乾	rou gan
葡萄乾	pu tao qian
蘇打餅乾	su da bing qian
蘿蔔乾	luo bo qian
蟶乾	cheng qian
豆乾	dou qian
豆腐乾	dou fu qian
豬肉乾	zhu rou qian
陰乾	yin gan
陵土未乾	ling tu wei qian
霉乾菜	mei gan cai
顛乾倒坤	dian gan dao kun
顛倒乾坤	dian dao qian kun
風乾	feng gan
餅乾	bing qian
香乾	xiang qian
馬乾	ma gan
馬乾	ma qian
黃乾黑瘦	huang qian hei shou
龍眼乾	long yan qian
