三樂	san yue
不亦樂乎	bu yi le hu
不可與共樂	bu ke yu gong le
不容樂觀	bu rong le guan
不快樂	bu kuai le
不樂	bu le
不樂觀	bu le guan
中秋快樂	zhong qiu kuai le
之樂	zhi le
于飛之樂	xu fei zhi le
于飛之樂	xu fei zhi yue
交響樂	jiao xiang yue
交響樂團	jiao xiang yue tuan
享樂	xiang le
享樂主義	xiang le zhu yi
仁者樂山	ren zhe yue shan
仙樂	xian yue
休閒娛樂	xiu xian yu le
伯樂	bo yue
伯樂一顧	bo yue yi gu
何樂不爲	he le bu wei
佚樂	yi le
佛教音樂	fo jiao yin yue
你快樂	ni kuai le
俗樂	su yue
信樂團	xin yue tuan
俱樂部	ju le bu
假樂	jia le
健康快樂	jian kang kuai le
偷着樂	tou zhe le
傻樂	sha le
優樂	you le
先憂後樂	xian you hou le
兒童樂園	er tong le yuan
六樂	liu yue
其樂不窮	qi le bu qiong
其樂無比	qi le wu bi
其樂無窮	qi le wu qiong
其樂融融	qi le rong rong
凱樂	kai le
利樂	li le
利樂包	li le bao
刮刮樂	gua gua le
制禮作樂	zhi li zuo yue
助人爲樂	zhu ren wei le
包爾德樂	bao er de le
南樂	nan le
博樂縣	bo liao xian
及時行樂	ji shi xing le
取樂	qu le
古典音樂	gu dian yin yue
古天樂	ku tian le
古樂	gu yue
可共患難不可共安樂	ge gong huan nuo bu ke gong an le
可共患難不可共安樂	ke gong huan nuo bu ke gong an le
可口可樂	ke kou ke le
可樂	ke le
合成樂器	he cheng yue qi
同樂	tong le
同樂會	tong le hui
君子三樂	jun zi san le
吹奏樂器	chui zou yue qi
吹樂器	chui le qi
吹樂器	chui liao qi
吹樂器	chui luo qi
吹樂器	chui yao qi
吹樂器	chui yue qi
和樂	he le
和聲樂器	he sheng yue qi
咍樂	hai yue
唐樂	tang yue
喜怒哀樂	xi nu ai le
喜樂	xi le
喜聞樂見	xi wen le jian
喫喝玩樂	chi he wan le
器樂	qi yue
噪音音樂	zao yin yin le
國家音樂廳	guo jia yin yue ting
國樂	guo yue
國民樂派音樂	guo min yue pai yin yue
夏威夷音樂	xia wei yi yin yue
夔龍禮樂	kui mang li yue
大家樂	da jia le
天倫之樂	tian lun zhi le
奏樂	zou yue
女樂	nv yue
好善樂施	hao shan le sh
好善樂施	hao shan le yi
好施樂善	hao sh yue shan
好施樂善	hao yi yue shan
娛樂	yu le
娛樂八卦	yu le ba gua
娛樂圈	yu yue quan
娛樂場所	yu le chang suo
娛樂性	yu yue xing
娛樂新聞	yu le xin wen
娛樂業	yu le ye
娛樂活動	yu le huo dong
娛樂片	yu le pian
娛樂界	yu le jie
娛樂界	yu yue jie
娛樂稅	yu le shui
娛樂節目	yu le jie mu
媽媽樂	ma ma le
子卯不樂	zi mao bu le
安和樂利	an he le li
安土樂業	an tu le ye
安堵樂業	an zhe le ye
安家樂業	an jia le ye
安居樂業	an ju le ye
安樂	an le
安樂世界	an le shi jie
安樂公主	an le gong zhu
安樂國	an le guo
安樂椅	an le yi
安樂死	an le si
安樂窩	an le wo
安貧樂賤	an pin le jian
安貧樂道	an pin le dao
安身樂業	an shen le ye
宗教音樂	zong jiao yin yue
室內樂	shi nei yue
宴樂	yan yue
家樂	jia le
家樂福	jia le fu
富強康樂	fu qiang kang le
寓教於樂	yu jiao yu le
尋樂	xun le
尋歡作樂	xun huan zuo le
小山樂府	xiao shan yue fu
平樂	ping le
幸災樂禍	xing zai le huo
幾家歡樂幾家愁	ji jia huan le ji jia chou
底下奏樂	di xia zou le
康樂	kang yue
康樂活動	kang le huo dong
弦樂	xian le
弦樂器	xian yue qi
很快樂	hen kuai le
心靈音樂	xin ling yin yue
快快樂樂	kuai kuai le le
快樂	kuai le
快樂丸	kuai le wan
快樂主義	kuai le zhu yi
忽忽不樂	hu hu bu le
怏怏不樂	yang yang bu le
怡然自樂	yi ran zi le
悅樂	yue le
悒悒不樂	yi yi bu le
悶悶不樂	men men bu le
愛心刮刮樂	ai xin gua gua le
愷樂	kai le
慘然不樂	can ran bu le
戴高樂	dai gao le
房中樂	fang zhong yue
打擊樂	da ji yue
打擊樂器	da ji yue qi
找樂子	zhao le zi
拉丁美洲音樂	la ding mei zhou yin le
推賢樂善	tui xian le shan
損者三樂	sun zhe san le
搖擺樂	yao bai yue
搖滾樂	yao gun yue
撥弦樂器	bo xian luo qi
擦弦樂器	ca xian yue qi
散樂	san yue
敬業樂羣	jing ye le qun
敲擊樂器	qiao ji yue qi
敲擊音樂	qiao ji yin yue
敲擊音樂	qiao xi yin yue
文樂傀儡	wen yue kui lei
新年快樂	xin nian kuai le
新浪娛樂	xin lang yu le
新爵士樂	xin jue shi yue
智者樂水	zhi zhe yue shui
曲肱之樂	qu gong zhi le
朝歌暮樂	zhu ge mu yue
朝歡暮樂	chao huan mu le
木管樂器	mu guan le qi
村天樂	cun tian le
林樂知	lin le zhi
柏林樂派	bo lin le pai
森林遊樂區	sen lin you le qu
極樂	ji le
極樂世界	ji yue shi jie
極樂鳥	ji le niao
樂不可支	le bu ke zhi
樂不可極	le bu ke ji
樂不可言	le bu ke yan
樂不思蜀	le bu si shu
樂事	le shi
樂亭大鼓	lao ting da gu
樂人	le ren
樂人	yue ren
樂以忘憂	yue yi wang you
樂利	le li
樂句	yue ju
樂史	yue shi
樂呵	le he
樂呵呵	le he he
樂和	le he
樂品	le pin
樂品	yue pin
樂善	le shan
樂善不倦	le shan bu juan
樂善好施	le shan hao yi
樂善好義	yue shan hao yi
樂嘻嘻	le xi xi
樂器	yue qi
樂國	le guo
樂園	le yuan
樂團	yue tuan
樂土	yue tu
樂在其中	le zai qi zhong
樂境	le jing
樂壇	yue tan
樂天	le tian
樂天安命	le tian an ming
樂天派	le tian pai
樂天知命	le tian zhi ming
樂婦	le fu
樂子	le zi
樂子館	le zi guan
樂山	le shan
樂山樂水	le shan le shui
樂山樂水	le shan yue shui
樂工	yue gong
樂師	le shi
樂府	yue fu
樂府指迷	yue fu zhi mi
樂府詩	yue fu shi
樂府詩集	yue fu shi ji
樂府雜錄	yue fu za lu
樂式	le shi
樂律	yue lv
樂得	le dei
樂意	le yi
樂手	le shou
樂捐	le juan
樂探	le tan
樂於	le yu
樂施	yue sh
樂施	yue yi
樂昌分破鏡	yue chang fen po jing
樂昌破鏡	yue chang po jing
樂易	liao yi
樂普	yue pu
樂曲	yue qu
樂棚	le peng
樂業	le ye
樂業安居	le ye an ju
樂極則悲	le ji ze bei
樂極忘形	le ji wang xing
樂極悲來	le ji bei lai
樂極悲生	le ji bei sheng
樂極悲生	yue ji bei sheng
樂極生悲	le ji sheng bei
樂樂	le le
樂樂陶陶	le le tao tao
樂歌	le ge
樂正	yue zheng
樂此不倦	le ci bu juan
樂此不疲	le ci bu pi
樂歲	yao sui
樂毅	yue yi
樂毅論	le yi lun
樂池	le chi
樂浪	yue lang
樂清	le qing
樂滋滋	le zi zi
樂牀	le chuang
樂理	yue li
樂禍	le huo
樂禍幸災	yue huo xing zai
樂章	yue zhang
樂籍	yue ji
樂素	le su
樂經	le jing
樂經	yue jing
樂網	le wang
樂羣	le qun
樂翁	le weng
樂而不淫	yue er bu yin
樂而不荒	le er bu kang
樂而忘憂	le er wang you
樂而忘歸	le er wang gui
樂而忘返	le er wang fan
樂聖	yue sheng
樂聲	yue sheng
樂育	le yue
樂舞	yue wu
樂處	le ju
樂處又逢悲	le chu you feng bei
樂融融	le rong rong
樂觀	le guan
樂觀主義	le guan zhu yi
樂觀其成	le guan i cheng
樂觀其成	le guan q cheng
樂觀進取	le guan jin qu
樂託	le tuo
樂記	yue ji
樂語	le yu
樂論	yue lun
樂譜	yue pu
樂貧甘賤	luo pin gan jian
樂購	le gou
樂趣	le qu
樂輸	le shu
樂迷	yue mi
樂透	le tou
樂遊原	yue you yuan
樂道	le dao
樂道安貧	le dao an pin
樂部	yue bu
樂陶陶	le tao tao
樂隊	yue dui
樂音	le yin
樂風	yue feng
標題音樂	biao di yin yue
標題音樂	biao ti yin yue
欣然自樂	xin ran zi le
歌樂	ge le
歌舞作樂	ge wu zuo le
歡樂	huan le
歡樂谷	huan le gu
死於安樂	si yu an le
民俗音樂	min su yin yue
民族樂器	min zu yue qi
民族樂隊	min zu yue dui
民族音樂	min zu yin le
民族音樂	min zu yin yue
民樂	min yue
氣鳴樂器	qi ming yue qi
永樂	yong le
永樂	yong liao
永樂	yong luo
永樂	yong yao
永樂	yong yue
永樂大典	yong yue da dian
永樂宮	yong le gong
永樂窯	yong le yao
永樂錢	yong le qian
泌水樂飢	mi shui le ji
洛可可音樂	luo ke ke yin yue
津津樂道	jin jin le dao
流行音樂	liu xing yin yue
浪漫樂派	lang man yue pai
清商樂	qing shang yue
清樂	qing yue
潮樂	chao le
熱門音樂	re men yin yue
燕樂二十八調	yan yue er shi ba diao
燕樂半字譜	yan yue ban zi pu
燕樂考源	yan yue kao yuan
爲善最樂	wei shan zui le
爲樂	wei yue
爵士樂	jue shi yue
狄斯奈樂園	di si nai le yuan
狄斯耐樂園	di shi nai le yuan
獨樂樂	du le le
獨樂樂	du yue le
玩樂	wan le
甘貧樂道	gan pin le dao
生日快樂	sheng ri kuai le
白樂天	bai yue tian
百事可樂	bai shi ke le
百樂	bai yue
益者三樂	yi zhe san le
知命樂天	zhi ming le tian
知者樂水	zhi zhe yue shui
知足常樂	zhi zu chang le
知魚之樂	zhi yu zhi le
破陣樂	po zhen yue
磨喝樂	mo he le
禮壞樂崩	li hui yue beng
禮壞樂缺	li hui yue que
禮崩樂壞	li beng yue hui
禮廢樂崩	li fei yue beng
禮樂	li le
禮樂	li yue
禮樂崩壞	li yue beng huai
禮樂爲鉤	li yue wei gou
秦王破陣樂	qin wang po zhen yue
移調樂器	yi diao yue qi
管弦樂	guan xian yue
管弦樂團	guan xian yue tuan
管樂	guan yue
管樂器	guan yue qi
管樂隊	guan yue dui
節日快樂	jie ri kuai le
簧樂器	huang yue qi
粗樂	cu le
細樂	xi yue
絃樂	xian le
絕對音樂	jue dui yin yue
絲竹樂	si zhu yue
網路咖啡俱樂部	wang lu ka fei ju luo bu
網路音樂廳	wang lu yin le ting
老人俱樂部	lao ren ju le bu
耽樂	dan le
聆樂	ling yue
聖樂	sheng yue
聖誕快樂	sheng dan kuai le
聲樂	sheng yue
聽音樂	ting yin yue
育樂	yu le
背景音樂	bei jing yin yue
胡樂	hu yue
能樂	neng le
能樂	neng yue
膜鳴樂器	mo ming yue qi
自娛自樂	zi yu zi le
自得其樂	zi de qi le
至樂	zhi le
與民偕樂	yu min xie le
與民同樂	yu min tong le
舉酒作樂	ju jiu zuo le
舞樂	wu yue
般樂	ban le
芭樂	ba le
芭樂票	ba le piao
苦中作樂	ku zhong zuo le
苦樂	ku le
莎樂美	sha yue mei
蓮花樂	lian hua le
行樂	xing le
行樂圖	xing le tu
衣冠禮樂	yi guan li yue
衾枕之樂	qin zhen zhi yue
西方極樂世界	xi fang ji le shi jie
西樂	xi yue
西海岸爵士樂	xi hai an jue shi le
西班牙音樂	xi ban ya yin yue
詩書禮樂	shi shu li yue
豐樂	feng le
豐樂亭	feng le ting
財去人安樂	cai qu ren an le
財去身安樂	cai qu shen an le
貧而樂道	pin er le dao
買樂	mai yue
賞心樂事	shang xin le shi
躬耕樂道	gong geng le dao
軍樂	jun yue
軍樂隊	jun yue dui
輕音樂	qing yin yue
農家樂	nong jia le
迪斯尼樂園	di si ni yue yuan
追歡取樂	zhuī huan qu le
逗樂	dou le
逢場作樂	feng chang zuo le
進酒作樂	jin jiu zuo le
逸樂	yi le
遊樂	you le
遊樂園	you le yuan
遊樂場	you le chang
遊樂林	you le lin
遊樂林	you yue lin
鄉村音樂	xiang cun yin yue
配樂	pei yue
酣樂	han le
鈞天廣樂	jun tian kuang yue
鈞天樂	jun tian le
銅管樂器	tong guan le qi
銅管樂隊	tong guan le dui
銅管樂隊	tong guan liao dui
銅管樂隊	tong guan luo dui
銅管樂隊	tong guan yao dui
銅管樂隊	tong guan yue dui
鍵盤樂器	jian pan yue qi
長樂	chang yue
長樂宮	chang yue gong
長樂未央	chang le wei yang
隨緣樂助	sui yuan le zhu
雅樂	ya yue
電子音樂	dian zi yin yue
電樂器	dian yue qi
電腦音樂	dian nao yin yue
電視遊樂器	dian shi you le qi
靡靡之樂	mi mi zhi le
音樂	yin yue
音樂人	yin yue ren
音樂劇	yin yue ju
音樂卡	yin yue ka
音樂圖書館	yin le tu shu guan
音樂圖書館	yin liao tu shu guan
音樂圖書館	yin luo tu shu guan
音樂圖書館	yin yao tu shu guan
音樂圖書館	yin yue tu shu guan
音樂學院	yin yue xue yuan
音樂家	yin yue jia
音樂廳	yin yue ting
音樂手機	yin yue shou ji
音樂播放	yin yue bo fang
音樂會	yin yue hui
音樂治療	yin yue zhi liao
音樂片	yin yue pian
音樂盒	yin yue he
音樂站	yin yue zhan
音樂節	yin yue jie
音樂臺	yin yue tai
音樂鋸	yin yue ju
音樂電鈴	yin yue dian ling
音樂風格	yin yue feng ge
韶樂	shao yue
飲酒作樂	yin jiu zuo le
饒樂	rao le
馬伯樂	ma ba le
高樂	gao le
鬱鬱不樂	yu yu bu le
魚樂	yu le
黑人音樂	hei ren yin le
鼓吹樂	gu chui le
鼓樂	gu yue
鼓樂喧天	gu yue xuan tian
